000000000000000000000000000000
000000000000001111000000000000
000000111100000000000000000000
000000000000000000000000000000
111111111111111111111111111111
