0000000000000000000000000000000000000000
0000000000000000000000000000000000000000
0000000000000011110000000000000000000000
0000000C00000000000000000011110000000000
0000001111000000000000000000000000000000
0000000000000000001111000000000000000000
0000000000000000000000000000000011110000
0000000000111100000000000000000000000000
0000000000000000000000000011110000000000
0000000000000000000000000000000000000000
0000000011110000000000000000000011110000
0000000000000000001111000000000000000000
0000000000000000000000000000000000000000
0000000000000011110000000000000000000000
0000000000000000000000000011110000000000
0000001111000000000000000000000000000000
0000000000000000000G00000000000011110000
0000000000000000001111000000000000000000
0S000CCC00000000000000000000000000000000
1111111111111111111111111111111111111111