111111111111111111111111111111111111111111111111111111111111111111111111111111111111111111111111111111
1000000000000000000000000000000000000000000000000000000000000000000000000000000000000000000000000001
102222222200000000022222222200000000022222222200000000022222222200000000022222222200000000022222222201
1000000000000000000000000000000000000000000000000000000000000000000000000000000000000000000000000001
1000000000000000333333000000000000000333333000000000000333333000000000000333333000000000000000000001
1000000000000000000000000000000000000000000000000000000000000000000000000000000000000000000000000001
102222222222222000000000022222222222222000000000022222222222222000000000022222222222222000000000022221
1000000000000000000000000000000000000000000000000000000000000000000000000000000000000000000000000001
1000000000000000000000000333333333333000000000000000000333333333333000000000000000000000000000000001
1000000000000000000000000000000000000000000000000000000000000000000000000000000000000000000000000001
102222222200000000022222222200000000022222222200000000022222222200000000022222222200000000022222222201
1000000000000000000000000000000000000000000000000000000000000000000000000000000000000000000000000001
1000000000000000000000000000000000333333000000000000000000000000333333000000000000000000000000000001
1000000000000000000000000000000000000000000000000000000000000000000000000000000000000000000000000001
102222222222222000000000022222222222222000000000022222222222222000000000022222222222222000000000022221
1000000000000000000000000000000000000000000000000000000000000000000000000000000000000000000000000001
1000000000000000000000000000000000000000000000000000000000000000000000000000000000000000000000000001
1000000000000000000000000000222222222222222220000000000000222222222222222220000000000000000000000001
1S000CCC000M000000000000000000000000E000000000000000000000000000CCC000M00000000000000000000000000001
111111111111111111111111111111111111111111111111111111111111111111111111111111111111111111111111111111
