000000000000000000000000000000000000000000000000000000000000000000000000000000000000000000000000000000000000000000000000000000
000000000000000000000000000000000000000000000000000000000000000000000000000000000000000000000000000000000000000000000000000000
000000000000000000001111111111111000000000000000000000000000001111111111111000000000000000000000000000001111111111111000000000
000000000000000000000000000000000000000000111111000000000000000000000000000000000000111111000000000000000000000000000000000000
000000000000111111111100000000000000000000000000000000000000111111111100000000000000000000111111111100000000000000000000000000
000000000000000000000000000000001111111111111000000000000000000000000000000000001111111111111000000000000000000000000000000000
000000000000000000000000000000000000000000000000000000000000000000000000000000000000000000000000000000000000000000000000000000
000000111111111111000000000000000000000000000000000000111111111111000000000000000000000000000000111111111111000000000000000000
000000000000000000000000000000111111111100000000000000000000000000000000000000111111111100000000000000000000000000000000000000
000000000000000000000000000000000000000000000000000000000000000000000000000000000000000000000000000000000000000000000000000000
000000000000111111111111111000000000000000111111111100000000000000111111111111111000000000000000111111111100000000000000000000
000000000000000000000000000000000000000000000000000000000000000000000000000000000000000000000000000000000000000000000000000000
000000000000000000000000000000001111111111111000000000000000000000000000000000001111111111111000000000000000000000000000000000
000000000000000000111111000000000000000000000000000000000000000000000000000000000000000000000000111111000000000000000000000000
000000000000000000000000000000000000000000000000000000000000000000000000000000000000000000000000000000000000000000000000000000
000000111111111111000000000000000000001111111111000000000000000000111111111111000000000000000000111111111111000000000000000000
000000000000000000000000000000000000000000000000000000000000000000000000000000000000000000000000000000000000000000000000000000
000000000000000000000000000011111111111111111000000000000000000000000000000000000000001111111111111111000000000000000000000000
000000S000CCC000M00000000000000000000E000000000000000000000000S000CCC000M00000000000000000000E0000000000000000000000000000000000
111111111111111111111111111111111111111111111111111111111111111111111111111111111111111111111111111111111111111111111111111111
